ad-cí	acatar
ad-cí	accatar
ad-aig	ad-acht
at-bail(l)	atbail
brága	brágaid
beus	béos
cleittíne	cleitini
cleittíne	cletine
cloch	clochaib
cosc	coisc	cois
con-tuili	con-atil
do-icc	con-tánic
co	conda
co	cucut
co	cuici
oíbind	aíminni
baile	bailiu
cathair	cathrig
cotut	cotat
cathair	cathir
dḯuite	dḯuite,diúiti,diúite,diuiti
díním	dínnim
airgaire	ergairi
guth	gotha
góach	góig
léicid	léiced
gaibid	ragbad
ráma	rámada
rígin	rígin
ulaid	ultaib
ulaid	ulad
ulaid	ulltaib
ulaid	ultib
écosc	écoisc
eó	éo
ériu	ére
íar	íarsind
óenmac	óenmac
óenfer	óenfir